XXXXXXXX
X......X
X..B...X
X......X
X......X
X.P....E
X......X
XXXXXXXX